+--+--+--+--+--+
               |
+--+  +--+--+--+
|              |
+--+--+  +--+  +
|     |  |  |  |
+  +--+  +  +  +
|           |  |
+--+  +--+  +--+
|        |      
+--+--+--+--+--+
